########........................................................................................................................................................
########........................................................................................................................................................
########........................................................................................................................................................
########........................................................................................................................................................
########........................................................................................................................................................
########........................................................................................................................................................
########........................................................................................................................................................
########........................................................................................................................................................
################................................................................................................................................................
################................................................................................................................................................
################................................................................................................................................................
################................................................................................................................................................
################................................................................................................................................................
################................................................................................................................................................
################................................................................................................................................................
################................................................................................................................................................
################................................................................................................................................................
################................................................................................................................................................
################................................................................................................................................................
################................................................................................................................................................
################................................................................................................................................................
################................................................................................................................................................
################................................................................................................................................................
################................................................................................................................................................
#.......########................................................................................................................................................
.#......########................................................................................................................................................
..#.....########................................................................................................................................................
#.#.....########................................................................................................................................................
..#.....########................................................................................................................................................
#.#.....########................................................................................................................................................
.#......########................................................................................................................................................
#.......########................................................................................................................................................
##......########................................................................................................................................................
..#.....########................................................................................................................................................
#..#....########................................................................................................................................................
.#.#....########................................................................................................................................................
#..#....########................................................................................................................................................
.#.#....########................................................................................................................................................
..#.....########................................................................................................................................................
##......########................................................................................................................................................
###.....########................................................................................................................................................
...#....########................................................................................................................................................
##..#...########................................................................................................................................................
..#.#...########................................................................................................................................................
##..#...########................................................................................................................................................
..#.#...########................................................................................................................................................
...#....########................................................................................................................................................
###.....########................................................................................................................................................
####....########................................................................................................................................................
....#...########................................................................................................................................................
###..#..########................................................................................................................................................
#..#.#..########................................................................................................................................................
###..#..########................................................................................................................................................
#..#.#..########................................................................................................................................................
....#...########................................................................................................................................................
####....########................................................................................................................................................
.####...########................................................................................................................................................
#....#..########................................................................................................................................................
.###..#.########................................................................................................................................................
.#..#.#.########................................................................................................................................................
.###..#.########................................................................................................................................................
.#..#.#.########................................................................................................................................................
#....#..########................................................................................................................................................
.####...########................................................................................................................................................
..####..........................................................................................................................................................
.#....#.........................................................................................................................................................
#.###..#........................................................................................................................................................
#.#..#.#........................................................................................................................................................
#.###..#........................................................................................................................................................
#.#..#.#........................................................................................................................................................
.#....#.........................................................................................................................................................
..####..........................................................................................................................................................
...####.........................................................................................................................................................
..#....#........................................................................................................................................................
.#.###..#.......................................................................................................................................................
.#.#..#.#.......................................................................................................................................................
.#.###..#.......................................................................................................................................................
.#.#..#.#.......................................................................................................................................................
..#....#........................................................................................................................................................
...####.........................................................................................................................................................
....####........................................................................................................................................................
...#....#.......................................................................................................................................................
..#.###..#......................................................................................................................................................
..#.#..#.#......................................................................................................................................................
..#.###..#......................................................................................................................................................
..#.#..#.#......................................................................................................................................................
...#....#.......................................................................................................................................................
....####........................................................................................................................................................
.....####.......................................................................................................................................................
....#....#......................................................................................................................................................
...#.###..#.....................................................................................................................................................
...#.#..#.#.....................................................................................................................................................
...#.###..#.....................................................................................................................................................
...#.#..#.#.....................................................................................................................................................
....#....#......................................................................................................................................................
.....####.......................................................................................................................................................
......####......................................................................................................................................................
.....#....#.....................................................................................................................................................
....#.###..#....................................................................................................................................................
....#.#..#.#....................................................................................................................................................
....#.###..#....................................................................................................................................................
....#.#..#.#....................................................................................................................................................
.....#....#.....................................................................................................................................................
......####......................................................................................................................................................
.......####.....................................................................................................................................................
......#....#....................................................................................................................................................
.....#.###..#...................................................................................................................................................
.....#.#..#.#...................................................................................................................................................
.....#.###..#...................................................................................................................................................
.....#.#..#.#...................................................................................................................................................
......#....#....................................................................................................................................................
.......####.....................................................................................................................................................
........####....................................................................................................................................................
.......#....#...................................................................................................................................................
......#.###..#..................................................................................................................................................
......#.#..#.#..................................................................................................................................................
......#.###..#..................................................................................................................................................
......#.#..#.#..................................................................................................................................................
.......#....#...................................................................................................................................................
........####....................................................................................................................................................
.........####...................................................................................................................................................
........#....#..................................................................................................................................................
.......#.###..#.................................................................................................................................................
.......#.#..#.#.................................................................................................................................................
.......#.###..#.................................................................................................................................................
.......#.#..#.#.................................................................................................................................................
........#....#..................................................................................................................................................
.........####...................................................................................................................................................
..........####..########........................................................................................................................................
.........#....#.########........................................................................................................................................
........#.###..#########........................................................................................................................................
........#.#..#.#########........................................................................................................................................
........#.###..#########........................................................................................................................................
........#.#..#.#########........................................................................................................................................
.........#....#.########........................................................................................................................................
..........####..########........................................................................................................................................
...........####.########........................................................................................................................................
..........#....#########........................................................................................................................................
.........#.###..########........................................................................................................................................
.........#.#..#.########........................................................................................................................................
.........#.###..########........................................................................................................................................
.........#.#..#.########........................................................................................................................................
..........#....#########........................................................................................................................................
...........####.########........................................................................................................................................
