........########................................................................................................................................................
........########................................................................................................................................................
........########................................................................................................................................................
........########................................................................................................................................................
........########................................................................................................................................................
........########................................................................................................................................................
........########................................................................................................................................................
........########................................................................................................................................................
........########................................................................................................................................................
........########................................................................................................................................................
#.......########................................................................................................................................................
#.......########................................................................................................................................................
#.......########................................................................................................................................................
#.......########................................................................................................................................................
........########................................................................................................................................................
........########................................................................................................................................................
........########................................................................................................................................................
#.......########................................................................................................................................................
.#......########................................................................................................................................................
.#......########................................................................................................................................................
.#......########................................................................................................................................................
.#......########................................................................................................................................................
#.......########................................................................................................................................................
........########................................................................................................................................................
#...............########........................................................................................................................................
.#..............########........................................................................................................................................
..#.............########........................................................................................................................................
#.#.............########........................................................................................................................................
..#.............########........................................................................................................................................
#.#.............########........................................................................................................................................
.#..............########........................................................................................................................................
#...............########........................................................................................................................................
##..............########........................................................................................................................................
..#.............########........................................................................................................................................
#..#............########........................................................................................................................................
.#.#............########........................................................................................................................................
#..#............########........................................................................................................................................
.#.#............########........................................................................................................................................
..#.............########........................................................................................................................................
##..............########........................................................................................................................................
###.............########........................................................................................................................................
...#............########........................................................................................................................................
##..#...........########........................................................................................................................................
..#.#...........########........................................................................................................................................
##..#...........########........................................................................................................................................
..#.#...........########........................................................................................................................................
...#............########........................................................................................................................................
###.............########........................................................................................................................................
####............########........................................................................................................................................
....#...........########........................................................................................................................................
###..#..........########........................................................................................................................................
#..#.#..........########........................................................................................................................................
###..#..........########........................................................................................................................................
#..#.#..........########........................................................................................................................................
....#...........########........................................................................................................................................
####............########........................................................................................................................................
.####...........########........................................................................................................................................
#....#..........########........................................................................................................................................
.###..#.........########........................................................................................................................................
.#..#.#.........########........................................................................................................................................
.###..#.........########........................................................................................................................................
.#..#.#.........########........................................................................................................................................
#....#..........########........................................................................................................................................
.####...........########........................................................................................................................................
..####..........................................................................................................................................................
.#....#.........................................................................................................................................................
#.###..#........................................................................................................................................................
#.#..#.#........................................................................................................................................................
#.###..#........................................................................................................................................................
#.#..#.#........................................................................................................................................................
.#....#.........................................................................................................................................................
..####..........................................................................................................................................................
...####.........................................................................................................................................................
..#....#........................................................................................................................................................
.#.###..#.......................................................................................................................................................
.#.#..#.#.......................................................................................................................................................
.#.###..#.......................................................................................................................................................
.#.#..#.#.......................................................................................................................................................
..#....#........................................................................................................................................................
...####.........................................................................................................................................................
....####........................................................................................................................................................
...#....#.......................................................................................................................................................
..#.###..#......................................................................................................................................................
..#.#..#.#......................................................................................................................................................
..#.###..#......................................................................................................................................................
..#.#..#.#......................................................................................................................................................
...#....#.......................................................................................................................................................
....####........................................................................................................................................................
.....####.......########........................................................................................................................................
....#....#......########........................................................................................................................................
...#.###..#.....########........................................................................................................................................
...#.#..#.#.....########........................................................................................................................................
...#.###..#.....########........................................................................................................................................
...#.#..#.#.....########........................................................................................................................................
....#....#......########........................................................................................................................................
.....####.......########........................................................................................................................................
......####......########........................................................................................................................................
.....#....#.....########........................................................................................................................................
....#.###..#....########........................................................................................................................................
....#.#..#.#....########........................................................................................................................................
....#.###..#....########........................................................................................................................................
....#.#..#.#....########........................................................................................................................................
.....#....#.....########........................................................................................................................................
......####......########........................................................................................................................................
.......####.....########........................................................................................................................................
......#....#....########........................................................................................................................................
.....#.###..#...########........................................................................................................................................
.....#.#..#.#...########........................................................................................................................................
.....#.###..#...########........................................................................................................................................
.....#.#..#.#...########........................................................................................................................................
......#....#....########........................................................................................................................................
.......####.....########........................................................................................................................................
........####....########........................................................................................................................................
.......#....#...########........................................................................................................................................
......#.###..#..########........................................................................................................................................
......#.#..#.#..########........................................................................................................................................
......#.###..#..########........................................................................................................................................
......#.#..#.#..########........................................................................................................................................
.......#....#...########........................................................................................................................................
........####....########........................................................................................................................................
.........####...########........................................................................................................................................
........#....#..########........................................................................................................................................
.......#.###..#.########........................................................................................................................................
.......#.#..#.#.########........................................................................................................................................
.......#.###..#.########........................................................................................................................................
.......#.#..#.#.########........................................................................................................................................
........#....#..########........................................................................................................................................
.........####...########........................................................................................................................................
..........####..................................................................................................................................................
.........#....#.................................................................................................................................................
........#.###..#................................................................................................................................................
........#.#..#.#................................................................................................................................................
........#.###..#................................................................................................................................................
........#.#..#.#................................................................................................................................................
.........#....#.................................................................................................................................................
..........####..................................................................................................................................................
...........####.................................................................................................................................................
..........#....#................................................................................................................................................
.........#.###..#...............................................................................................................................................
.........#.#..#.#...............................................................................................................................................
.........#.###..#...............................................................................................................................................
.........#.#..#.#...............................................................................................................................................
..........#....#................................................................................................................................................
...........####.................................................................................................................................................
